Qxua^Xo, Qxua^Xo, Qxua^Xo, Qxua^Xo, Qxua^Xo, Qxua^Xo, Qxua^Xo, Qxua^Xo, Qxua^Xo, Qxua^Xo, Qxua^Xo, Qxua^Xo, Qxua^Xo, Qxua^Xo, Qxua^Xo, Qxua^Xo, Qxua^Xo, Qxua^Xo, Qxua^Xo, Qxua^Xo, Qxua^Xo, Qxua^Xo, Qxua^Xo, Qxua^Xo, Qxua^Xo, Qxua^Xo, Qxua^Xo, Qxua^Xo, Qxua^Xo, Qxua^Xo, Qxua^Xo, Qxua^Xo, Qxua^Xo, Qxua^Xo, Qxua^Xo, Qxua^Xo, Qxua^Xo, Qxua^Xo, Qxua^Xo
Qxua^Xo, Qxua^Xo, Qxua^Xo, Qxua^Xo, Qxua^Xo, Qxua^Xo, Qxua^Xo, Qxua^Xo, Qxua^Xo, Qxua^Xo, Qxua^Xo, Qxua^Xo, Qxua^Xo, Qxua^Xo, Qxua^Xo, Qxua^Xo, Qxua^Xo, Qxua^Xo, Qxua^Xo, Qxua^Xo, Qxua^Xo, Qxua^Xo, Qxua^Xo, Qxua^Xo, Qxua^Xo, Qxua^Xo, Qxua^Xo, Qxua^Xo, Qxua^Xo, Qxua^Xo, Qxua^Xo, Qxua^Xo, Qxua^Xo, Qxua^Xo, Qxua^Xo, Qxua^Xo, Qxua^Xo, Qxua^Xo, Qxua^Xo
Qxua^Xo, Qxua^Xo, Qxua^Xo, Qxua^Xo, Qxua^Xo, Qxua^Xo, Qxua^Xo, Qxua^Xo, Qxua^Xo, Qxua^Xo, Hhd, Qxua^Xo, Ss, Qxua^Xo, Qxua^Xo, Qxua^Xo, Qxua^Xo, Qxua^Xo, Qxua^Xo, Qxua^Xo, Qxua^Xo, Qxua^Xo, Qxua^Xo, Qxua^Xo, Qxua^Xo, Qxua^Xo, Ss, Qxua^Xo, Ss, Qxua^Xo, Qxua^Xo, Qxua^Xo, Qxua^Xo, Qxua^Xo, Qxua^Xo, Qxua^Xo, Qxua^Xo, Qxua^Xo, Qxua^Xo
Qxua^Xo, Qxua^Xo, Qxua^Xo, Qxua^Xo, Qxua^Xo, Qxua^Xo, Qxua^Xo, Qxua^Xo, Dd, Dd, Hhd, Ss, Ur, Ss, Ur, Qxua^Xo, Qxua^Xo, Qxua^Xo, Qxua^Xo, Qxua^Xo, Qxua^Xo, Qxua^Xo, Qxua^Xo, Qxua^Xo, Wwg, Ss, Ss, Ss, Hhd, Ss, Chs, Qxua^Xo, Qxua^Xo, Qxua^Xo, Qxua^Xo, Qxua^Xo, Qxua^Xo, Qxua^Xo, Qxua^Xo
Qxua^Xo, Qxua^Xo, Qxua^Xo, Qxua^Xo, Qxua^Xo, Qxua^Xo, Md^Xm, Hhd, Dd, Dd, Re, Hhd, Ss, Ss, Ss, Ss, Ss, Qxua^Xo, Qxua^Xo, Qxua^Xo, Qxua^Xo, Qxua^Xo, Wwf, Wwf, Re, Wwf, Wwf, Hhd, Hhd, Ss, Wwg, Wwg, Hhd, Qxua^Xo, Qxua^Xo, Qxua^Xo, Qxua^Xo, Qxua^Xo, Qxua^Xo
Qxua^Xo, Qxua^Xo, Qxua^Xo, Qxua^Xo, Re^Fp, Hhd^Fp, Hhd, Hhd^Fp, Re, Re, Re, Wwg, Wwg, Ss, Hh, Ur, Gs^Fp, Ss, Ss, Qxua^Xo, Ss, Wwf, Hhd^Fp, Re, Re, Re, Re, Wwf, Wwf, Wwf, Re, Re^Fp, Hhd^Fp, Md^Xm, Hhd^Fp, Qxua^Xo, Qxua^Xo, Qxua^Xo, Qxua^Xo
Qxua^Xo, Qxua^Xo, Qxua^Xo, Qxua^Xo, Re^Fp, Sm, Re, Cea, Re^Fp, Re, Wwg, Wwg^Bw\, Gs, Gs, Gd, Hh, Hh, Ss, Ss, Qxua^Xo, Ss, Wwf, Re, Re, Re^Fp, Hhd, Hhd^Fp, Re, Wwg, Re, Re, Cea, Re, Hhd, Re^Fp, Qxua^Xo, Qxua^Xo, Qxua^Xo, Qxua^Xo
Qxua^Xo, Qxua^Xo, Qxua^Xo, Re^Uf, Re, Re, Wwf, Wwf, Wwg, Wwg, Wwg, Gg, Wwf, Gd, Wwf, Hhd, Hh, Gs^Fp, Ss, Ss, Wwf, Wwf, Wwf^Bw|, Re, Hhd, Md, Wwf, Re, Wwf, Wwf, Wwf, Wwf, Wwf, Re, Re, Re, Qxua^Xo, Qxua^Xo, Qxua^Xo
Qxua^Xo, Qxua^Xo, Qxua^Xo, Gs^Fds, Rrc, Re, Wwf, Xu, Xu, Uh, Hh, Wwf, Hh, Wwf, Gd, Wwf, Wwf, Hhd^Fp, Wwf, Ss, Wwf, Hhd, Re, Wwg, Wwf, Wwf, Hh, Wwf, Hh, Uh, Xu, Xu, Wwf, Re, Rrc, Gs^Fds, Qxua^Xo, Qxua^Xo, Qxua^Xo
Qxua^Xo, Qxua^Xo, Gg^Fds, Gg^Fds, Gs, Re, Wwf, Xu, 1 Cud, Xu, Uh, Ur, Uu^Uf, Ss, Gd^Fp, Re, Rd, Wwf, Re, Wwf, Hhd, Ce, Rd, Re, Hh^Dr, Ss, Uh, Ur, Uu^Uf, Xu, Cud, Xu, Wwf, Re, Gs, Gg^Fds, Gg^Fds, Qxua^Xo, Qxua^Xo
Qxua^Xo, Gg^Fds, Cvr, Cvr, Cvr, Re, Re, Wwf, 3 Cud, Xu, Ur, Ur, Ss, Hh, Hhd^Fp, Rd, Rd, Rd, Rd, Rd, Rd, Rd, Rd, Rd, Hhd, Hh^Fp, Ss, Ur, Ur, Xu, 7 Cud, Wwf, Re, Re, Cvr, Cvr, Cvr, Gg^Fds, Qxua^Xo
Qxua^Xo, Gg^Fds, Cvr, 4 Cv, Cvr, Gs^Fds, Re, Wwg, 6 Cud, Xu, Ur, Uh^Ft, Ss, Md, Hhd, Dd, Rd, Rd, Rd, Rd, Rd, Rd, Rd, Dd, Hhd^Fp, Md, Ss, Uh^Ft, Ur, Xu, 5 Cud, Wwg, Re, Gs^Fds, Cvr, 8 Cv, Cvr, Gg^Fds, Qxua^Xo
Qxua^Xo, Gg^Fds, Gg^Fds, Cvr, Gs, Re, Wwf, Wwf, Cud, Xu, Uu^Uf, Ur, Uh, Hh^Fp, Hh^Dr, Rd, Rd, Rd, Hhd, Rd, Re, Rd, Rd, Rd, Gd^Fp, Hh, Uu^Uf, Ur, Uh, Xu, 2 Cud, Wwf, Wwf, Re, Gs, Cvr, Gg^Fds, Gg^Fds, Qxua^Xo
Qxua^Xo, Qxua^Xo, Qxua^Xo, Gg^Fds, Rrc, Re, Wwf, Xu, Xu, Xu, Hh, Ur, Hh, Ss, Wwf, Re, Re, Ce, Wwf, Wwf, Wwf, Wwf, Wwf, Re, Gd, Ss, Hh, Ur, Hh, Xu, Xu, Xu, Wwf, Re, Rrc, Gg^Fds, Qxua^Xo, Qxua^Xo, Qxua^Xo
Qxua^Xo, Qxua^Xo, Qxua^Xo, Gs^Fds, Re, Re, Wwf, Xu, Wwf, Uh, Wwf, Wwf, Wwf, Wwf, Hhd, Wwg, Wwf^Bw|, Hhd, Wwf, Ss, Ss, Hhd^Fp, Hh, Wwf, Wwf, Wwf, Wwf, Wwf, Wwg, Uh, Wwg, Xu, Wwf, Re, Re, Gs^Fds, Qxua^Xo, Qxua^Xo, Qxua^Xo
Qxua^Xo, Qxua^Xo, Qxua^Xo, Re, Re^Fp, Re, Re, Wwf, Re, Wwf, Wwg, Re, Hhd^Fp, Md, Re^Fp, Re, Re, Wwf, Ss, Ss, Ss, Gs^Fp, Hh, Hhd, Gd, Gd, Gs, Gg, Wwg, Wwg, Re^Fp, Wwf, Re, Re, Re^Fp, Re^Uf, Qxua^Xo, Qxua^Xo, Qxua^Xo
Qxua^Xo, Qxua^Xo, Qxua^Xo, Qxua^Xo, Hhd^Fp, Hhd, Hhd^Fp, Cea, Re, Re, Wwf, Re, Re, Hhd, Re, Re, Hhd^Fp, Wwf, Ss, Qxua^Xo, Ss, Ss, Gs^Fp, Hh, Hh, Gs, Wwg, Wwg^Bw\, Re, Re, Re, Cea, Hhd, Sm, Re^Fp, Qxua^Xo, Qxua^Xo, Qxua^Xo, Qxua^Xo
Qxua^Xo, Qxua^Xo, Qxua^Xo, Qxua^Xo, Qxua^Xo, Md^Xm, Hhd, Re^Fp, Wwg, Wwf, Hhd, Wwf, Wwf, Re, Re, Re, Wwf, Wwf, Qxua^Xo, Qxua^Xo, Qxua^Xo, Ss, Ss, Ur, Ss, Ss, Ss, Wwg, Re, Re, Dd, Hhd^Fp, Md^Xm, Hhd^Fp, Qxua^Xo, Qxua^Xo, Qxua^Xo, Qxua^Xo, Qxua^Xo
Qxua^Xo, Qxua^Xo, Qxua^Xo, Qxua^Xo, Qxua^Xo, Qxua^Xo, Qxua^Xo, Wwg, Chs, Ss, Hhd, Hhd, Ss, Wwf, Wwg, Wwf, Qxua^Xo, Qxua^Xo, Qxua^Xo, Qxua^Xo, Qxua^Xo, Qxua^Xo, Qxua^Xo, Ss, Ur, Ss, Ur, Hhd, Hhd, Dd, Dd, Hhd, Qxua^Xo, Qxua^Xo, Qxua^Xo, Qxua^Xo, Qxua^Xo, Qxua^Xo, Qxua^Xo
Qxua^Xo, Qxua^Xo, Qxua^Xo, Qxua^Xo, Qxua^Xo, Qxua^Xo, Qxua^Xo, Qxua^Xo, Qxua^Xo, Ss, Ss, Ss, Ss, Ss, Qxua^Xo, Qxua^Xo, Qxua^Xo, Qxua^Xo, Qxua^Xo, Qxua^Xo, Qxua^Xo, Qxua^Xo, Qxua^Xo, Qxua^Xo, Qxua^Xo, Ss, Ss, Ss, Hhd, Dd, Qxua^Xo, Qxua^Xo, Qxua^Xo, Qxua^Xo, Qxua^Xo, Qxua^Xo, Qxua^Xo, Qxua^Xo, Qxua^Xo
Qxua^Xo, Qxua^Xo, Qxua^Xo, Qxua^Xo, Qxua^Xo, Qxua^Xo, Qxua^Xo, Qxua^Xo, Qxua^Xo, Qxua^Xo, Qxua^Xo, Qxua^Xo, Qxua^Xo, Qxua^Xo, Qxua^Xo, Qxua^Xo, Qxua^Xo, Qxua^Xo, Qxua^Xo, Qxua^Xo, Qxua^Xo, Qxua^Xo, Qxua^Xo, Qxua^Xo, Qxua^Xo, Qxua^Xo, Qxua^Xo, Qxua^Xo, Qxua^Xo, Qxua^Xo, Qxua^Xo, Qxua^Xo, Qxua^Xo, Qxua^Xo, Qxua^Xo, Qxua^Xo, Qxua^Xo, Qxua^Xo, Qxua^Xo
Qxua^Xo, Qxua^Xo, Qxua^Xo, Qxua^Xo, Qxua^Xo, Qxua^Xo, Qxua^Xo, Qxua^Xo, Qxua^Xo, Qxua^Xo, Qxua^Xo, Qxua^Xo, Qxua^Xo, Qxua^Xo, Qxua^Xo, Qxua^Xo, Qxua^Xo, Qxua^Xo, Qxua^Xo, Qxua^Xo, Qxua^Xo, Qxua^Xo, Qxua^Xo, Qxua^Xo, Qxua^Xo, Qxua^Xo, Qxua^Xo, Qxua^Xo, Qxua^Xo, Qxua^Xo, Qxua^Xo, Qxua^Xo, Qxua^Xo, Qxua^Xo, Qxua^Xo, Qxua^Xo, Qxua^Xo, Qxua^Xo, Qxua^Xo
Qxua^Xo, Qxua^Xo, Qxua^Xo, Qxua^Xo, Qxua^Xo, Qxua^Xo, Qxua^Xo, Qxua^Xo, Qxua^Xo, Qxua^Xo, Qxua^Xo, Qxua^Xo, Qxua^Xo, Qxua^Xo, Qxua^Xo, Qxua^Xo, Qxua^Xo, Qxua^Xo, Qxua^Xo, Qxua^Xo, Qxua^Xo, Qxua^Xo, Qxua^Xo, Qxua^Xo, Qxua^Xo, Qxua^Xo, Qxua^Xo, Qxua^Xo, Qxua^Xo, Qxua^Xo, Qxua^Xo, Qxua^Xo, Qxua^Xo, Qxua^Xo, Qxua^Xo, Qxua^Xo, Qxua^Xo, Qxua^Xo, Qxua^Xo
