Qxua, Qxua, Qxua, Qxua, Qxua, Qxua, Qxua, Qxua, Qxua, Qxua, Qxua, Qxua, Qxua, Qxua, Qxua, Qxua, Qxua, Qxua, Qxua, Qxua, Qxua, Qxua, Qxua, Qxua, Qxua, Qxua, Qxua, Qxua, Qxua, Qxua, Qxua, Qxua, Qxua, Qxua, Qxua, Qxua, Qxua
Qxua, Qxua, Qxua, Qxua, Qxua, Qxua, Qxua, Qxua, Qxua, Qxua, Qxua, Qxua, Qxua, Qxua, Qxua, Qxua, Qxua, Qxua, Qxua, Qxua, Qxua, Qxua, Qxua, Qxua, Qxua, Qxua, Qxua, Qxua, Qxua, Qxua, Qxua, Qxua, Qxua, Qxua, Qxua, Qxua, Qxua
Qxua, Qxua, Qxua, Qxua, Qxua, Qxua, Qxua, Qxua, Qxua, Qxua, Qxua, Qxua, Qxua, Qxua, Ur, Qxua, Ss, Qxua, Ur, Qxua, Wwf, Qxua, Uh, Qxua, Qxua, Qxua, Qxua, Qxua, Qxua, Qxua, Qxua, Qxua, Qxua, Qxua, Qxua, Qxua, Qxua
Qxua, Qxua, Qxua, Qxua, Qxua, Qxua, Qxua, Qxua, Qxua, Qxua, Wwf, Wwf, Wwf, Ur, Ss, Ur, Ss, Ur, Uh, Wwf, Chw, Wwf, Wwf, Ur, Wwf, Wwf, Wwf, Qxua, Qxua, Qxua, Qxua, Qxua, Qxua, Qxua, Qxua, Qxua, Qxua
Qxua, Qxua, Qxua, Qxua, Qxua, Qxua, Qxua, Qxua, Hh, Wwf, Gs^Fp, Hh^Fp, Wwf, Ur, Ss, Ss^Fp, Ss, Ss, Ss, Wwf, Wwf, Gg^Ftr, Hh, Wwf^Ewl, Ds, Ds, Gs^Efm, Ds, Wwf, Qxua, Qxua, Qxua, Qxua, Qxua, Qxua, Qxua, Qxua
Qxua, Qxua, Qxua, Qxua, Qxua, Qxua, Wwf, Wwf, Wwf^Ewl, Wwf, Wwf, Gs^Efm, Gs^Efm, Wwf, Gs^Efm, Gs^Fp, Hh, Mm, Hhd, Hhd, Wwf, Hh, Gs^Efm, Gs^Efm, Gg^Efm, Hh, Ce, Gg^Efm, Wwf, Gll, Gd^Fdf, Qxua, Qxua, Qxua, Qxua, Qxua, Qxua
Qxua, Qxua, Qxua, Qxua, Wwf, Wwf, Gll^Efm, Cea, Ur, Mm, Wwf, Ds, Gs^Efm, Gs^Efm, Hh, Gs^Efm, Gs^Efm, Gs^Fp, Wwf, Wwf, Gs^Efm, Wwf, Wwf^Ewf, Gs^Efm, Gg^Ft, Gg^Efm, Gg^Efm, Gg^Efm, Wwf, Cea, Gd^Efm, Gll^Fdf, Gll^Efm, Qxua, Qxua, Qxua, Qxua
Qxua, Qxua, Qxua, Qxua, Wwf, Gd^Efm, Ur, Ur, Xu, Ur, Ur^Uf, Wwf, Gs^Efm, Hh, Hh^Fp, Gs^Efm, Gs^Efm, Gs^Efm, Wwf, Gs^Efm, Gs^Fp, Gs^Efm, Wwg^Bw\, Hh, Md, Hh, Ur, Uh, Xu, Wwf, Wwf, Hhd, Gll^Fdf, Qxua, Qxua, Qxua, Qxua
Qxua, Qxua, Qxua, Wwf, Wwf^Ewf, Rp, Wwf, Uh, Xu, Xu, Xu, Wwf^Ewf, Wwf, Wwg, Wwg, Gs^Efm, Wwf^Bsb\, Wwf, Sm, Chs, Ss, Wwrg, Wwg, Ur, Ur, Ur, Xu, Xu, Xu, Ur, Wwf, Rp, Gd^Fdf, Gd^Fdf, Qxua, Qxua, Qxua
Qxua, Qxua, Wwf, Wwf, Ch, Wwf, Gll^Efm, Wwf, Ur, 1 Cud, Xu, Xu, Ur, Uh, Uu^Uf, Wwf^Ewl, Ur, Rb, Ss, Mm^Xm, Mm, Wog, Uh, Uu^Uf, Ur, Xu, Xu, Cud, Ur, Wwf, Gd^Fdf, Gd^Efm, Ch, Wwf, Wwf, Qxua, Qxua
Qxua, Qxua, Wwf, Ch, 4 Cud, Ch, Gd^Efm, Wwf, Rb, 3 Cud, Xu, Ur, Uu^Uf, Uu, Ss, Wwg, Ur^Ft, Rb, Ur, Ur, Ur^Ft, Wwg, Ss, Uu, Uu^Uf, Ur, Xu, 7 Cud, Rb, Wwf, Gd^Efm, Ch, 8 Cud, Ch, Wwf, Qxua, Qxua
Qxua, Qxua, Wwf, Ch, Ch, Ch, Gd^Fdf, Wwf, Ur, 6 Cud, Xu, Ur, Ur, Uu, Uh, Wwg^Ewf, Mm, Ur, Ss, Rb, Ur, Wwg^Ewf, Uu^Uf, Uu, Ur, Ur, Xu, 5 Cud, Ur, Wwf, Gll^Efm, Ch, Ch, Ch, Wwf, Qxua, Qxua
Qxua, Qxua, Qxua, Wwf, Gd^Fdf, Gd^Efm, Wwf, Wwf, Xu, Cud, Xu, Xu, Ur, Uu^Uf, Ww^Ewl, Wog, Ss, Mm^Xm, Sm, Rb, Wwf^Bsb\, Wwf, Wwg, Uh, Wwf, Xu, Xu, 2 Cud, Xu, Wwf, Wwf, Wwf^Ewf, Wwf, Wwf, Qxua, Qxua, Qxua
Qxua, Qxua, Qxua, Gd^Fdf, Gll^Fdf, Rp, Wwf, Ur, Xu, Xu, Ur, Ur, Md, Ur, Wwg^Bw\, Wwrg, Gs^Fp, Chs, Wwf, Wwf^Ewf, Gs^Efm, Gs^Efm, Hh^Fp, Wwg, Gs^Efm, Wwf, Ur^Uf, Xu, Xu, Uh, Ur, Rp, Wwf, Wwf, Qxua, Qxua, Qxua
Qxua, Qxua, Qxua, Qxua, Gll^Efm, Hhd, Gd^Efm, Wwf, Wwf, Uh, Gg^Efm, Hh, Gg^Ft, Hh, Wwf, Gs^Efm, Gs^Efm, Gs^Efm, Wwf, Gs^Efm, Gs^Efm, Gs^Efm, Hh, Hh, Gs^Efm, Wwf, Wwf, Ur, Ur, Ur, Gll^Efm, Gd^Efm, Wwf, Qxua, Qxua, Qxua, Qxua
Qxua, Qxua, Qxua, Qxua, Qxua, Gll^Fdf, Gd^Fdf, Cea, Wwf, Gg^Efm, Ce, Gg^Efm, Gg^Efm, Gs^Efm, Gs^Efm, Wwf, Wwf, Wwf, Hhd, Gs^Fp, Hh, Gs^Efm, Gs^Efm, Gs^Efm, Gs^Efm, Ds, Wwf, Mm, Wwf, Cea, Wwf, Wwf, Qxua, Qxua, Qxua, Qxua, Qxua
Qxua, Qxua, Qxua, Qxua, Qxua, Qxua, Qxua, Gll, Wwf, Gg^Efm, Gs^Efm, Hh, Ds, Gs^Efm, Hh, Hh, Wwf, Hhd, Ss, Mm, Ss, Gs^Fp, Ss, Wwf, Wwf, Gs^Efm, Gs^Fp, Wwf, Hh, Wwf^Ewl, Qxua, Qxua, Qxua, Qxua, Qxua, Qxua, Qxua
Qxua, Qxua, Qxua, Qxua, Qxua, Qxua, Qxua, Qxua, Qxua, Ds, Wwf, Ds, Wwf, Wwf, Wwf, Gg^Ftr, Chw, Wwf, Uh, Ss, Ss, Ss^Fp, Ss, Ur, Wwf, Hh^Fp, Wwf, Wwf, Qxua, Qxua, Qxua, Qxua, Qxua, Qxua, Qxua, Qxua, Qxua
Qxua, Qxua, Qxua, Qxua, Qxua, Qxua, Qxua, Qxua, Qxua, Qxua, Qxua, Wwf, Qxua, Ur, Uh, Wwf^Ewf, Wwf, Wwf, Ur, Ur, Ss, Ur, Ur, Ur, Qxua, Wwf, Qxua, Qxua, Qxua, Qxua, Qxua, Qxua, Qxua, Qxua, Qxua, Qxua, Qxua
Qxua, Qxua, Qxua, Qxua, Qxua, Qxua, Qxua, Qxua, Qxua, Qxua, Qxua, Qxua, Qxua, Qxua, Qxua, Qxua, Qxua, Qxua, Qxua, Qxua, Qxua, Qxua, Qxua, Qxua, Qxua, Qxua, Qxua, Qxua, Qxua, Qxua, Qxua, Qxua, Qxua, Qxua, Qxua, Qxua, Qxua
Qxua, Qxua, Qxua, Qxua, Qxua, Qxua, Qxua, Qxua, Qxua, Qxua, Qxua, Qxua, Qxua, Qxua, Qxua, Qxua, Qxua, Qxua, Qxua, Qxua, Qxua, Qxua, Qxua, Qxua, Qxua, Qxua, Qxua, Qxua, Qxua, Qxua, Qxua, Qxua, Qxua, Qxua, Qxua, Qxua, Qxua
Qxua, Qxua, Qxua, Qxua, Qxua, Qxua, Qxua, Qxua, Qxua, Qxua, Qxua, Qxua, Qxua, Qxua, Qxua, Qxua, Qxua, Qxua, Qxua, Qxua, Qxua, Qxua, Qxua, Qxua, Qxua, Qxua, Qxua, Qxua, Qxua, Qxua, Qxua, Qxua, Qxua, Qxua, Qxua, Qxua, Qxua
