border_size=1
usage=map

Xv, Xv, Xv, Xv, Xv, Xv, Xv, Xv, Xv, Xv, Xv, Xv, Xv, Xv, Xv, Xv, Xv, Xv, Xv, Xv, Xv, Xv, Xv, Xv, Xv, Xv, Xv, Xv, Xv, Xv, Xv, Xv, Xv, Xv, Xv, Xv, Xv
Xv, Xv, Xv, Xv, Qxua^Xo, Xv, Qxua^Xo, Xv, Qxua^Xo, Xv, Xv, Xv, Xv, Xv, Xv, Xv, Xv, Xv, Xv, Xv, Xv, Xv, Xv, Xv, Xv, Xv, Xv, Xv, Qxua^Xo, Xv, Qxua^Xo, Xv, Qxua^Xo, Xv, Xv, Xv, Xv
Xv, Xv, Xv, Qxua^Xo, 1 Kh, Qxua^Xo, 4 Kh, Qxua^Xo, 8 Kh, Qxua^Xo, Xv, Xv, Xv, Xv, Qxua^Xo, Xv, Qxua^Xo, Qxua^Xo, Qxua^Xo, Qxua^Xo, Qxua^Xo, Xv, Qxua^Xo, Xv, Xv, Xv, Xv, Qxua^Xo, 2 Kh, Qxua^Xo, 3 Kh, Qxua^Xo, 6 Kh, Qxua^Xo, Xv, Xv, Xv
Xv, Xv, Xv, Qxua^Xo, Qxua^Xo, Qxua^Xo, Qxua^Xo, Qxua^Xo, Qxua^Xo, Qxua^Xo, Xv, Xv, Qxua^Xo, Qxua^Xo, Ww, Qxua^Xo, Ss, Ss, Ss, Ss, Ss, Qxua^Xo, Ww, Qxua^Xo, Qxua^Xo, Xv, Xv, Qxua^Xo, Qxua^Xo, Qxua^Xo, Qxua^Xo, Qxua^Xo, Qxua^Xo, Qxua^Xo, Xv, Xv, Xv
Xv, Xv, Xv, Xv, Xv, Xv, Qxua^Xo, Qxua^Xo, Qxua^Xo, Qxua^Xo, Qxua^Xo, Qxua^Xo, Gs^Fp, Hh, Ww, Ww, Ss, Ss, Ss, Ss, Ss, Ww, Ww, Gs^Fp, Hh, Qxua^Xo, Qxua^Xo, Qxua^Xo, Qxua^Xo, Qxua^Xo, Qxua^Xo, Xv, Xv, Xv, Xv, Xv, Xv
Xv, Xv, Xv, Xv, Xv, Qxua^Xo, Gs^Fp, Hh, Gg, Gs^Fp, Gg, Hh, Hh, Gg, Wwf, Gs, Gs, Hh, Mm, Hh, Gs, Gs, Wwf, Gg, Gs^Fp, Gs^Fp, Gg, Hh, Gg, Gs^Fp, Hh, Qxua^Xo, Xv, Xv, Xv, Xv, Xv
Xv, Xv, Xv, Xv, Qxua^Xo, Qxua^Xo, Gg, Gg, Ww, Gg, Ch, Gg, Gg, Gg, Ww, Gs^Ft, Gs, Gs^Ft, Rd, Gs^Ft, Gs, Hh, Ww, Gg, Gg, Gg, Ch, Gg, Ww, Gg, Gg, Qxua^Xo, Qxua^Xo, Xv, Xv, Xv, Xv
Xv, Xv, Xv, Xv, Qxua^Xo, Hh, Gg, Ww, Dd^Do, Wwf, Wwf, Wwf, Ww, Wwf, Hh, Ww, Wwf, Rd, Hh, Rd, Wwf, Ww, Gs^Fp, Wwf, Ww, Wwf, Wwf, Wwf, Dd^Do, Ww, Gg, Gs^Fp, Qxua^Xo, Xv, Xv, Xv, Xv
Xv, Xv, Xv, Qxua^Xo, Hh, Gg, Gg, Wwf, Gg, Gg, Xu, Xu, Xu, Gg, Gg, Gg, Ww, Hh, Hh, Hh, Ww, Gg, Gg, Gg, Xu, Xu, Xu, Gg, Gg, Wwf, Gg, Gg, Gs^Fp, Qxua^Xo, Xv, Xv, Xv
Xv, Xv, Qxua^Xo, Qxua^Xo, Ch, Gs^Fp, Gg, Ww, Gg, Gg, Wwf, Cud, Xu, Gs^Fp, Hh, Gs^Fp, Ww, Ww, Ww, Ww, Ww, Hh, Gs^Fp, Hh, Xu, Cud, Wwf, Gg, Gg, Ww, Gg, Hh, Ch, Qxua^Xo, Qxua^Xo, Xv, Xv
Xv, Xv, Qxua^Xo, Ch, 5 Cud, Ch, Wwf, Wwf, Wwf, Wwf, Gg, Cud, Xu, Uu, Uu^Uf, Ww, Wo, Wo, Wo, Wo, Wo, Ww, Uu^Uf, Uu, Xu, Cud, Gg, Wwf, Wwf, Wwf, Wwf, Ch, 7 Cud, Ch, Qxua^Xo, Xv, Xv
Xv, Xv, Qxua^Xo, Ch, Ch, Ch, Gg, Wwf, Gg, Wwf, Wwf, Cud, Xu, Uu, Gs^Fp, Ww, Ww, Wo, Ww, Wo, Ww, Ww, Hh, Uu, Xu, Cud, Wwf, Wwf, Gg, Wwf, Gg, Ch, Ch, Ch, Qxua^Xo, Xv, Xv
Xv, Xv, Qxua^Xo, Qxua^Xo, Gs^Fp, Hh, Gg, Ww, Gg, Gg, Xu, Cud, Xu, Hh, Gg, Hh, Ww, Ww, Hh, Ww, Ww, Gs^Fp, Gg, Gs^Fp, Xu, Cud, Xu, Gg, Gg, Ww, Gg, Gs^Fp, Hh, Qxua^Xo, Xv, Xv, Xv
Xv, Xv, Xv, Qxua^Xo, Qxua^Xo, Gg, Gg, Wwf, Dd^Do, Gg, Wwf, Xu, Ww, Gg, Gs^Fp, Gg, Wwf, Hh, Hh, Hh, Wwf, Gg, Hh, Gg, Ww, Xu, Wwf, Gg, Dd^Do, Wwf, Gg, Gg, Qxua^Xo, Qxua^Xo, Xv, Xv, Xv
Xv, Xv, Xv, Xv, Qxua^Xo, Gs^Fp, Gg, Ww, Ww, Wwf, Ch, Wwf, Gg, Wwf, Ww, Ww, Gs, Rd, Rd, Rd, Gs, Ww, Ww, Wwf, Gg, Wwf, Ch, Wwf, Ww, Ww, Gg, Hh, Qxua^Xo, Xv, Xv, Xv, Xv
Xv, Xv, Xv, Xv, Xv, Qxua^Xo, Hh, Gg, Gg, Gg, Gg, Gg, Gs^Fp, Gg, Wwf, Hh, Gs, Gs^Ft, Mm, Gs^Ft, Gs, Gs^Ft, Wwf, Gg, Hh, Gg, Gg, Gg, Gg, Gg, Gs^Fp, Qxua^Xo, Xv, Xv, Xv, Xv, Xv
Xv, Xv, Xv, Xv, Xv, Qxua^Xo, Qxua^Xo, Gs^Fp, Qxua^Xo, Hh, Qxua^Xo, Gs^Fp, Hh, Gg, Ww, Gs, Ss, Hh, Ss, Hh, Ss, Gs, Ww, Gg, Gs^Fp, Hh, Qxua^Xo, Gs^Fp, Qxua^Xo, Hh, Qxua^Xo, Qxua^Xo, Xv, Xv, Xv, Xv, Xv
Xv, Xv, Xv, Xv, Xv, Xv, Xv, Qxua^Xo, Xv, Qxua^Xo, Xv, Qxua^Xo, Qxua^Xo, Gs^Fp, Qxua^Xo, Ww, Ss, Ss, Ss, Ss, Ss, Ww, Qxua^Xo, Hh, Qxua^Xo, Qxua^Xo, Xv, Qxua^Xo, Xv, Qxua^Xo, Xv, Xv, Xv, Xv, Xv, Xv, Xv
Xv, Xv, Xv, Xv, Xv, Xv, Xv, Xv, Xv, Xv, Xv, Xv, Xv, Qxua^Xo, Xv, Qxua^Xo, Qxua^Xo, Ss, Qxua^Xo, Ss, Qxua^Xo, Qxua^Xo, Xv, Qxua^Xo, Xv, Xv, Xv, Xv, Xv, Xv, Xv, Xv, Xv, Xv, Xv, Xv, Xv
Xv, Xv, Xv, Xv, Xv, Xv, Xv, Xv, Xv, Xv, Xv, Xv, Xv, Xv, Xv, Xv, Xv, Qxua^Xo, Xv, Qxua^Xo, Xv, Xv, Xv, Xv, Xv, Xv, Xv, Xv, Xv, Xv, Xv, Xv, Xv, Xv, Xv, Xv, Xv
Xv, Xv, Xv, Xv, Xv, Xv, Xv, Xv, Xv, Xv, Xv, Xv, Xv, Xv, Xv, Xv, Xv, Xv, Xv, Xv, Xv, Xv, Xv, Xv, Xv, Xv, Xv, Xv, Xv, Xv, Xv, Xv, Xv, Xv, Xv, Xv, Xv
Xv, Xv, Xv, Xv, Xv, Xv, Xv, Xv, Xv, Xv, Xv, Xv, Xv, Xv, Xv, Xv, Xv, Xv, Xv, Xv, Xv, Xv, Xv, Xv, Xv, Xv, Xv, Xv, Xv, Xv, Xv, Xv, Xv, Xv, Xv, Xv, Xv
