border_size=1
usage=map

Wo          , Wo          , Wo          , Wo          , Wo          , Wo          , Wo          , Wo          , Wo          , Wo          , Wo          , Wo          , Wo          , Wo          , Wo          , Wo          , Wo          , Wo          , Wo          , Wo          , Wo          , Wo          , Wo          , Wo          , Wo          , Wo          , Wo          , Wo          , Wo          , Wo          , Wo          , Wo          , Wo          , Wo          , Wo          , Wo          , Wo          
Wo          , Wo          , Wo          , Wo          , Wo          , Wo          , Wo          , Wo          , Wo          , Wo          , Wo          , Wo          , Wo          , Wo          , Wo          , Wo          , Wo          , Wo          , Wo          , Wo          , Wo          , Wo          , Wo          , Wo          , Wo          , Wo          , Wo          , Wo          , Wo          , Wo          , Wo          , Wo          , Wo          , Wo          , Wo          , Wo          , Wo          
Wo          , Wo          , Wo          , Wo          , 1 Kh        , Wo          , 3 Kh        , Wo          , 6 Kh        , Wo          , Wo          , Wo          , Wo          , Wo          , Xv          , Wo          , Xv          , Xv          , Xv          , Xv          , Xv          , Wo          , Xv          , Wo          , Wo          , Wo          , Wo          , Wo          , 2 Kh        , Wo          , 5 Kh        , Wo          , 7 Kh        , Wo          , Wo          , Wo          , Wo          
Wo          , Wo          , Wo          , Wo          , Wo          , Wo          , Wo          , Wo          , Wo          , Wo          , Wo          , Wo          , Xv          , Xv          , Ww          , Xv          , Ss          , Ss          , Ss          , Ss          , Ss          , Xv          , Ww          , Xv          , Xv          , Wo          , Wo          , Wo          , Wo          , Wo          , Wo          , Wo          , Wo          , Wo          , Wo          , Wo          , Wo          
Wo          , Wo          , Wo          , Wo          , Wo          , Wo          , Xv          , Xv          , Xv          , Xv          , Xv          , Xv          , Gs^Fp       , Hh          , Ww          , Ww          , Ss          , Ss          , Ss          , Ss          , Ss          , Ww          , Ww          , Gs^Fp       , Hh          , Xv          , Xv          , Xv          , Xv          , Xv          , Xv          , Wo          , Wo          , Wo          , Wo          , Wo          , Wo          
Wo          , Wo          , Wo          , Wo          , Wo          , Xv          , Gs^Fp       , Hh          , Gg          , Gs^Fp       , Gg          , Hh          , Hh          , Gg          , Wwf         , Gs          , Gs          , Hh          , Mm          , Hh          , Gs          , Gs          , Wwf         , Gg          , Gs^Fp       , Gs^Fp       , Gg          , Hh          , Gg          , Gs^Fp       , Hh          , Xv          , Wo          , Wo          , Wo          , Wo          , Wo          
Wo          , Wo          , Wo          , Wo          , Xv          , Xv          , Gg          , Gg          , Ww          , Gg          , Ch          , Gg          , Gg          , Gg          , Ww          , Gs^Ft       , Gs          , Gs^Ft       , Rd          , Gs^Ft       , Gs          , Hh          , Ww          , Gg          , Gg          , Gg          , Ch          , Gg          , Ww          , Gg          , Gg          , Xv          , Xv          , Wo          , Wo          , Wo          , Wo          
Wo          , Wo          , Wo          , Wo          , Xv          , Hh          , Gg          , Ww          , Dd^Do       , Wwf         , Wwf         , Wwf         , Ww          , Wwf         , Hh          , Ww          , Wwf         , Rd          , Hh          , Rd          , Wwf         , Ww          , Gs^Fp       , Wwf         , Ww          , Wwf         , Wwf         , Wwf         , Dd^Do       , Ww          , Gg          , Gs^Fp       , Xv          , Wo          , Wo          , Wo          , Wo          
Wo          , Wo          , Wo          , Xv          , Hh          , Gg          , Gg          , Wwf         , Gg          , Gg          , Xu          , Xu          , Xu          , Gg          , Gg          , Gg          , Ww          , Hh          , Hh          , Hh          , Ww          , Gg          , Gg          , Gg          , Xu          , Xu          , Xu          , Gg          , Gg          , Wwf         , Gg          , Gg          , Gs^Fp       , Xv          , Wo          , Wo          , Wo          
Wo          , Wo          , Xv          , Xv          , Ch          , Gs^Fp       , Gg          , Ww          , Gg          , Gg          , Wwf         , Cud         , Xu          , Gs^Fp       , Hh          , Gs^Fp       , Ww          , Ww          , Ww          , Ww          , Ww          , Hh          , Gs^Fp       , Hh          , Xu          , Cud         , Wwf         , Gg          , Gg          , Ww          , Gg          , Hh          , Ch          , Xv          , Xv          , Wo          , Wo          
Wo          , Wo          , Xv          , Ch          , 8 Cud       , Ch          , Wwf         , Wwf         , Wwf         , Wwf         , Gg          , Cud         , Xu          , Uu          , Uu^Uf       , Ww          , Wo          , Wo          , Wo          , Wo          , Wo          , Ww          , Uu^Uf       , Uu          , Xu          , Cud         , Gg          , Wwf         , Wwf         , Wwf         , Wwf         , Ch          , 4 Cud       , Ch          , Xv          , Wo          , Wo          
Wo          , Wo          , Xv          , Ch          , Ch          , Ch          , Gg          , Wwf         , Gg          , Wwf         , Wwf         , Cud         , Xu          , Uu          , Gs^Fp       , Ww          , Ww          , Wo          , Ww          , Wo          , Ww          , Ww          , Hh          , Uu          , Xu          , Cud         , Wwf         , Wwf         , Gg          , Wwf         , Gg          , Ch          , Ch          , Ch          , Xv          , Wo          , Wo          
Wo          , Wo          , Wo          , Xv          , Gs^Fp       , Hh          , Gg          , Ww          , Gg          , Gg          , Xu          , Cud         , Xu          , Hh          , Gg          , Hh          , Ww          , Ww          , Hh          , Ww          , Ww          , Gs^Fp       , Gg          , Gs^Fp       , Xu          , Cud         , Xu          , Gg          , Gg          , Ww          , Gg          , Gs^Fp       , Hh          , Xv          , Wo          , Wo          , Wo          
Wo          , Wo          , Wo          , Xv          , Xv          , Gg          , Gg          , Wwf         , Dd^Do       , Gg          , Wwf         , Xu          , Ww          , Gg          , Gs^Fp       , Gg          , Wwf         , Hh          , Hh          , Hh          , Wwf         , Gg          , Hh          , Gg          , Ww          , Xu          , Wwf         , Gg          , Dd^Do       , Wwf         , Gg          , Gg          , Xv          , Xv          , Wo          , Wo          , Wo          
Wo          , Wo          , Wo          , Wo          , Xv          , Gs^Fp       , Gg          , Ww          , Ww          , Wwf         , Ch          , Wwf         , Gg          , Wwf         , Ww          , Ww          , Gs          , Rd          , Rd          , Rd          , Gs          , Ww          , Ww          , Wwf         , Gg          , Wwf         , Ch          , Wwf         , Ww          , Ww          , Gg          , Hh          , Xv          , Wo          , Wo          , Wo          , Wo          
Wo          , Wo          , Wo          , Wo          , Wo          , Xv          , Hh          , Gg          , Gg          , Gg          , Gg          , Gg          , Gs^Fp       , Gg          , Wwf         , Hh          , Gs          , Gs^Ft       , Mm          , Gs^Ft       , Gs          , Gs^Ft       , Wwf         , Gg          , Hh          , Gg          , Gg          , Gg          , Gg          , Gg          , Gs^Fp       , Xv          , Wo          , Wo          , Wo          , Wo          , Wo          
Wo          , Wo          , Wo          , Wo          , Wo          , Xv          , Xv          , Gs^Fp       , Xv          , Hh          , Xv          , Gs^Fp       , Hh          , Gg          , Ww          , Gs          , Ss          , Hh          , Ss          , Hh          , Ss          , Gs          , Ww          , Gg          , Gs^Fp       , Hh          , Xv          , Gs^Fp       , Xv          , Hh          , Xv          , Xv          , Wo          , Wo          , Wo          , Wo          , Wo          
Wo          , Wo          , Wo          , Wo          , Wo          , Wo          , Wo          , Xv          , Wo          , Xv          , Wo          , Xv          , Xv          , Gs^Fp       , Xv          , Ww          , Ss          , Ss          , Ss          , Ss          , Ss          , Ww          , Xv          , Hh          , Xv          , Xv          , Wo          , Xv          , Wo          , Xv          , Wo          , Wo          , Wo          , Wo          , Wo          , Wo          , Wo          
Wo          , Wo          , Wo          , Wo          , Wo          , Wo          , Wo          , Wo          , Wo          , Wo          , Wo          , Wo          , Wo          , Xv          , Wo          , Xv          , Xv          , Ss          , Xv          , Ss          , Xv          , Xv          , Wo          , Xv          , Wo          , Wo          , Wo          , Wo          , Wo          , Wo          , Wo          , Wo          , Wo          , Wo          , Wo          , Wo          , Wo          
Wo          , Wo          , Wo          , Wo          , Wo          , Wo          , Wo          , Wo          , Wo          , Wo          , Wo          , Wo          , Wo          , Wo          , Wo          , Wo          , Wo          , Xv          , Wo          , Xv          , Wo          , Wo          , Wo          , Wo          , Wo          , Wo          , Wo          , Wo          , Wo          , Wo          , Wo          , Wo          , Wo          , Wo          , Wo          , Wo          , Wo          
Wo          , Wo          , Wo          , Wo          , Wo          , Wo          , Wo          , Wo          , Wo          , Wo          , Wo          , Wo          , Wo          , Wo          , Wo          , Wo          , Wo          , Wo          , Wo          , Wo          , Wo          , Wo          , Wo          , Wo          , Wo          , Wo          , Wo          , Wo          , Wo          , Wo          , Wo          , Wo          , Wo          , Wo          , Wo          , Wo          , Wo          
Wo          , Wo          , Wo          , Wo          , Wo          , Wo          , Wo          , Wo          , Wo          , Wo          , Wo          , Wo          , Wo          , Wo          , Wo          , Wo          , Wo          , Wo          , Wo          , Wo          , Wo          , Wo          , Wo          , Wo          , Wo          , Wo          , Wo          , Wo          , Wo          , Wo          , Wo          , Wo          , Wo          , Wo          , Wo          , Wo          , Wo          
