border_size=1
usage=map

Wo          , Wo          , Wo          , Wo          , Wo          , Wo          , Wo          , Wo          , Wo          , Wo          , Wo          , Wo          , Wo          , Wo          , Wo          , Wo          , Wo          , Wo          , Wo          , Wo          , Wo          , Wo          , Wo          , Wo          , Wo          , Wo          , Wo          , Wo          , Wo          , Wo          , Wo          , Wo          , Wo          , Wo          , Wo          , Wo          , Wo          
Wo          , Wo          , Wo          , Wo          , Wo          , Wo          , Xv          , Xv          , Xv          , Xv          , Xv          , Wo          , Wo          , Wo          , Wo          , Wo          , Xv          , Wo          , Xv          , Wo          , Wo          , Wo          , Wo          , Wo          , Xv          , Xv          , Xv          , Xv          , Xv          , Wo          , Wo          , Wo          , Wo          , Wo          , Wo          , Wo          , Wo          
Wo          , Wo          , Wo          , Wo          , Wo          , Wo          , Xv          , 1 Kh        , Xv          , 5 Kh        , Xv          , Wo          , Wo          , Wo          , Wo          , Xv          , 2 Kh        , Xv          , 7 Kh        , Xv          , Wo          , Wo          , Wo          , Wo          , Xv          , 4 Kh        , Xv          , 8 Kh        , Xv          , Wo          , Wo          , Wo          , Wo          , Wo          , Wo          , Wo          , Wo          
Wo          , Wo          , Wo          , Wo          , Wo          , Wo          , Wo          , Xv          , Wo          , Xv          , Wo          , Wo          , Wo          , Wo          , Wo          , Xv          , Xv          , Xv          , Xv          , Xv          , Wo          , Wo          , Wo          , Wo          , Wo          , Xv          , Wo          , Xv          , Wo          , Wo          , Wo          , Wo          , Wo          , Wo          , Wo          , Wo          , Wo          
Wo          , Wo          , Wo          , Wo          , Wo          , Wo          , Wo          , Wo          , Xv          , Wo          , Wo          , Wo          , Wo          , Wo          , Wo          , Wo          , Wo          , Wo          , Wo          , Wo          , Wo          , Wo          , Wo          , Wo          , Wo          , Wo          , Xv          , Wo          , Wo          , Wo          , Wo          , Wo          , Wo          , Wo          , Wo          , Wo          , Wo          
Wo          , Wo          , Wo          , Wo          , Wo          , Wo          , Xv          , Xv          , Gg          , Xv          , Xv          , Wo          , Wo          , Wo          , Wo          , Wo          , Wo          , Wo          , Wo          , Wo          , Wo          , Wo          , Wo          , Wo          , Xv          , Xv          , Gg          , Xv          , Xv          , Wo          , Wo          , Wo          , Wo          , Wo          , Wo          , Wo          , Wo          
Wo          , Wo          , Wo          , Wo          , Xv          , Xv          , Gs^Fp       , Gg          , Gg          , Hh          , Gg          , Xv          , Xv          , Wo          , Wo          , Wo          , Wo          , Wo          , Wo          , Wo          , Wo          , Wo          , Xv          , Xv          , Gg          , Hh          , Gg          , Gg          , Gs^Fp       , Xv          , Xv          , Wo          , Wo          , Wo          , Wo          , Wo          , Wo          
Wo          , Wo          , Xv          , Xv          , Ch          , Gg          , Hh          , Dd^Do       , Wwf         , Wwf         , Wwf         , Wwf         , Wwf         , Xv          , Xv          , Wo          , Wo          , Wo          , Wo          , Wo          , Xv          , Xv          , Wwf         , Wwf         , Wwf         , Wwf         , Wwf         , Dd^Do       , Hh          , Gg          , Ch          , Xv          , Xv          , Wo          , Wo          , Wo          , Wo          
Wo          , Wo          , Xv          , Ch          , 9 Cud       , Ch          , Wwf         , Wwf         , Gg          , Gg          , Gg          , Ch          , Gg          , Ss          , Ss          , Xv          , Xv          , Wo          , Xv          , Xv          , Gg          , Ww          , Gg          , Ch          , Gg          , Gg          , Gg          , Wwf         , Wwf         , Ch          , 6 Cud       , Ch          , Xv          , Wo          , Wo          , Wo          , Wo          
Wo          , Wo          , Xv          , Ch          , Ch          , Ch          , Gg          , Wwf         , Gg          , Xu          , Xu          , Gg          , Gg          , Gg          , Gs^Ft       , Ss          , Ss          , Xv          , Hh^Fp       , Gs^Fmf      , Gg          , Ww          , Gs^Fmf      , Gg          , Xu          , Xu          , Gg          , Wwf         , Gg          , Ch          , Ch          , Ch          , Xv          , Wo          , Wo          , Wo          , Wo          
Wo          , Wo          , Xv          , Gg          , Hh          , Wwf         , Wwf         , Wwf         , Ww          , Ch          , Xu          , Uu          , Wwr         , Hh          , Wwf         , Ss          , Ss          , Xv          , Gs^Fmf      , Gs^Fmf      , Gg          , Wwf         , Ww          , Uu          , Xu          , Ch          , Ww          , Wwf         , Wwf         , Wwf         , Hh          , Gg          , Xv          , Wo          , Wo          , Wo          , Wo          
Wo          , Wo          , Xv          , Gs^Fp       , Dd^Do       , Wwf         , Gg          , Gg          , Ch          , Xu          , Uu          , Uu          , Wwf         , Wwf         , Gg          , Gs^Ft       , Ss          , Hd          , Gg          , Gg          , Ha^Fma      , Hh          , Ww          , Uu          , Uu          , Xu          , Ch          , Gg          , Gg          , Wwf         , Dd^Do       , Gs^Fp       , Xv          , Wo          , Wo          , Wo          , Wo          
Wo          , Wo          , Xv          , Gg          , Gg          , Wwf         , Gg          , Xu          , Xu          , Xu          , Uu          , Uu^Uf       , Ww          , Ai          , Gg          , Gg          , Ss          , Gg          , Hh^Fp       , Gg          , Wwf         , Hh          , Ww          , Uu^Uf       , Uu          , Xu          , Xu          , Xu          , Gg          , Wwf         , Gg          , Gg          , Xv          , Wo          , Wo          , Wo          , Wo          
Wo          , Wo          , Xv          , Gg          , Hh          , Wwf         , Wwf         , Gg          , Gg          , Uu          , Ww          , Ww          , Hh          , Ww          , Gg          , Hh^Fp       , Wwr         , Mm          , Wwf         , Wwf         , Gg          , Ww          , Ai          , Wwf         , Wwr         , Uu          , Gg          , Gg          , Wwf         , Wwf         , Hh          , Gg          , Xv          , Wo          , Wo          , Wo          , Wo          
Wo          , Wo          , Wo          , Xv          , Xv          , Gg          , Wwf         , Ch          , Gg          , Gs^Fmf      , Wwf         , Hh          , Ha^Fma      , Wwf         , Wwf         , Uh          , Wwf         , Ds          , Wwf         , Uh          , Hh^Fp       , Gg          , Gg          , Wwf         , Hh          , Gg          , Gg          , Ch          , Wwf         , Gg          , Xv          , Xv          , Wo          , Wo          , Wo          , Wo          , Wo          
Wo          , Wo          , Wo          , Wo          , Wo          , Xv          , Xv          , Wwf         , Ww          , Ww          , Gg          , Gg          , Gg          , Gg          , Hh^Fp       , Wwf         , Ds          , Wwf         , Ds          , Wwr         , Ss          , Gg          , Gs^Ft       , Wwf         , Gs^Ft       , Gg          , Ss          , Wwf         , Xv          , Xv          , Wo          , Wo          , Wo          , Wo          , Wo          , Wo          , Wo          
Wo          , Wo          , Wo          , Wo          , Wo          , Wo          , Wo          , Xv          , Xv          , Gg          , Gs^Fmf      , Gs^Fmf      , Gs^Fmf      , Gg          , Gg          , Mm          , Wwr         , Wwf         , Wwf         , Mm          , Gg          , Ss          , Ss          , Ss          , Ss          , Ss          , Xv          , Xv          , Wo          , Wo          , Wo          , Wo          , Wo          , Wo          , Wo          , Wo          , Wo          
Wo          , Wo          , Wo          , Wo          , Wo          , Wo          , Wo          , Wo          , Wo          , Xv          , Xv          , Hh^Fp       , Xv          , Hd          , Ss          , Ss          , Hh^Fp       , Uh          , Wwf         , Hh^Fp       , Gg          , Hd          , Xv          , Ss          , Xv          , Xv          , Wo          , Wo          , Wo          , Wo          , Wo          , Wo          , Wo          , Wo          , Wo          , Wo          , Wo          
Wo          , Wo          , Wo          , Wo          , Wo          , Wo          , Wo          , Wo          , Wo          , Wo          , Wo          , Xv          , Ss          , Ss          , Gs^Ft       , Gg          , Gg          , Gg          , Wwf         , Gg          , Gg          , Gs^Fmf      , Hh^Fp       , Xv          , Wo          , Wo          , Wo          , Wo          , Wo          , Wo          , Wo          , Wo          , Wo          , Wo          , Wo          , Wo          , Wo          
Wo          , Wo          , Wo          , Wo          , Wo          , Wo          , Wo          , Wo          , Wo          , Wo          , Wo          , Xv          , Ss          , Ss          , Wwf         , Gg          , Ai          , Ww          , Hh          , Ha^Fma      , Gg          , Gs^Fmf      , Gs^Fmf      , Xv          , Wo          , Wo          , Wo          , Wo          , Wo          , Wo          , Wo          , Wo          , Wo          , Wo          , Wo          , Wo          , Wo          
Wo          , Wo          , Wo          , Wo          , Wo          , Wo          , Wo          , Wo          , Wo          , Wo          , Wo          , Xv          , Ss          , Gs^Ft       , Hh          , Wwf         , Wwf         , Ww          , Ww          , Hh          , Wwf         , Gg          , Gg          , Xv          , Wo          , Wo          , Wo          , Wo          , Wo          , Wo          , Wo          , Wo          , Wo          , Wo          , Wo          , Wo          , Wo          
Wo          , Wo          , Wo          , Wo          , Wo          , Wo          , Wo          , Wo          , Wo          , Wo          , Wo          , Xv          , Ss          , Gg          , Gg          , Wwr         , Uu          , Uu^Uf       , Uu          , Ww          , Gs^Fmf      , Ww          , Ww          , Xv          , Wo          , Wo          , Wo          , Wo          , Wo          , Wo          , Wo          , Wo          , Wo          , Wo          , Wo          , Wo          , Wo          
Wo          , Wo          , Wo          , Wo          , Wo          , Wo          , Wo          , Wo          , Wo          , Wo          , Wo          , Xv          , Wwf         , Gg          , Gg          , Uu          , Xu          , Uu          , Xu          , Uu          , Gg          , Gg          , Wwf         , Xv          , Wo          , Wo          , Wo          , Wo          , Wo          , Wo          , Wo          , Wo          , Wo          , Wo          , Wo          , Wo          , Wo          
Wo          , Wo          , Wo          , Wo          , Wo          , Wo          , Wo          , Wo          , Wo          , Wo          , Wo          , Xv          , Wwf         , Ch          , Gg          , Xu          , Ch          , Xu          , Ch          , Xu          , Gg          , Ch          , Wwf         , Xv          , Wo          , Wo          , Wo          , Wo          , Wo          , Wo          , Wo          , Wo          , Wo          , Wo          , Wo          , Wo          , Wo          
Wo          , Wo          , Wo          , Wo          , Wo          , Wo          , Wo          , Wo          , Wo          , Wo          , Wo          , Xv          , Gg          , Wwf         , Gg          , Xu          , Gg          , Ww          , Gg          , Xu          , Gg          , Gg          , Wwf         , Xv          , Wo          , Wo          , Wo          , Wo          , Wo          , Wo          , Wo          , Wo          , Wo          , Wo          , Wo          , Wo          , Wo          
Wo          , Wo          , Wo          , Wo          , Wo          , Wo          , Wo          , Wo          , Wo          , Wo          , Wo          , Xv          , Hh          , Wwf         , Wwf         , Gg          , Wwf         , Wwf         , Wwf         , Gg          , Wwf         , Wwf         , Hh          , Xv          , Wo          , Wo          , Wo          , Wo          , Wo          , Wo          , Wo          , Wo          , Wo          , Wo          , Wo          , Wo          , Wo          
Wo          , Wo          , Wo          , Wo          , Wo          , Wo          , Wo          , Wo          , Wo          , Wo          , Wo          , Xv          , Gg          , Gg          , Dd^Do       , Wwf         , Wwf         , Gg          , Wwf         , Wwf         , Dd^Do       , Gg          , Gg          , Xv          , Wo          , Wo          , Wo          , Wo          , Wo          , Wo          , Wo          , Wo          , Wo          , Wo          , Wo          , Wo          , Wo          
Wo          , Wo          , Wo          , Wo          , Wo          , Wo          , Wo          , Wo          , Wo          , Wo          , Wo          , Xv          , Xv          , Gg          , Gs^Fp       , Hh          , Ch          , Ch          , Ch          , Hh          , Gs^Fp       , Gg          , Xv          , Xv          , Wo          , Wo          , Wo          , Wo          , Wo          , Wo          , Wo          , Wo          , Wo          , Wo          , Wo          , Wo          , Wo          
Wo          , Wo          , Wo          , Wo          , Wo          , Wo          , Wo          , Wo          , Wo          , Wo          , Wo          , Wo          , Wo          , Xv          , Xv          , Gg          , Ch          , 3 Cud       , Ch          , Gg          , Xv          , Xv          , Wo          , Wo          , Wo          , Wo          , Wo          , Wo          , Wo          , Wo          , Wo          , Wo          , Wo          , Wo          , Wo          , Wo          , Wo          
Wo          , Wo          , Wo          , Wo          , Wo          , Wo          , Wo          , Wo          , Wo          , Wo          , Wo          , Wo          , Wo          , Wo          , Wo          , Xv          , Xv          , Ch          , Xv          , Xv          , Wo          , Wo          , Wo          , Wo          , Wo          , Wo          , Wo          , Wo          , Wo          , Wo          , Wo          , Wo          , Wo          , Wo          , Wo          , Wo          , Wo          
Wo          , Wo          , Wo          , Wo          , Wo          , Wo          , Wo          , Wo          , Wo          , Wo          , Wo          , Wo          , Wo          , Wo          , Wo          , Wo          , Wo          , Xv          , Wo          , Wo          , Wo          , Wo          , Wo          , Wo          , Wo          , Wo          , Wo          , Wo          , Wo          , Wo          , Wo          , Wo          , Wo          , Wo          , Wo          , Wo          , Wo          
Wo          , Wo          , Wo          , Wo          , Wo          , Wo          , Wo          , Wo          , Wo          , Wo          , Wo          , Wo          , Wo          , Wo          , Wo          , Wo          , Wo          , Wo          , Wo          , Wo          , Wo          , Wo          , Wo          , Wo          , Wo          , Wo          , Wo          , Wo          , Wo          , Wo          , Wo          , Wo          , Wo          , Wo          , Wo          , Wo          , Wo          
Wo          , Wo          , Wo          , Wo          , Wo          , Wo          , Wo          , Wo          , Wo          , Wo          , Wo          , Wo          , Wo          , Wo          , Wo          , Wo          , Wo          , Wo          , Wo          , Wo          , Wo          , Wo          , Wo          , Wo          , Wo          , Wo          , Wo          , Wo          , Wo          , Wo          , Wo          , Wo          , Wo          , Wo          , Wo          , Wo          , Wo          
