Qxua, Qxua, Qxua, Qxua, Qxua, Qxua, Qxua, Qxua, Qxua, Qxua, Qxua, Qxua, Qxua, Qxua, Qxua, Qxua, Qxua, Qxua, Qxua, Qxua, Qxua, Qxua, Qxua, Qxua, Qxua, Qxua, Qxua, Qxua, Qxua, Qxua, Qxua, Qxua, Qxua, Qxua, Qxua, Qxua, Qxua
Qxua, Qxua, Qxua, Qxua, Qxua, Qxua, Qxua, Qxua, Qxua, Qxua, Qxua, Qxua, Qxua, Qxua, Qxua, Qxua, Qxua, Qxua, Qxua, Qxua, Qxua, Qxua, Qxua, Qxua, Qxua, Qxua, Qxua, Qxua, Qxua, Qxua, Qxua, Qxua, Qxua, Qxua, Qxua, Qxua, Qxua
Qxua, Qxua, Qxua, Qxua, Qxua, Qxua, Aa^Fpa, Ha, Gg, Aa^Fma, Gg, Ha, Ha, Qxua, Aa, Qxua, Aa^Fpa, Qxua, Aa, Qxua, Aa, Qxua, Aa, Qxua, Aa^Fpa, Aa^Fpa, Gg, Ha, Gg, Aa^Fma, Ha, Qxua, Qxua, Qxua, Qxua, Qxua, Qxua
Qxua, Qxua, Qxua, Qxua, Qxua, Qxua, Gg, Gg, Ww, Gg, Ch, Gg, Gg, Ms, Hh, Aa, Gll^Fmw, Aa^Fma, Aa^Fma, Aa, Gg, Aa, Ww, Aa, Gg, Gg, Ch, Gg, Ww, Gg, Gg, Qxua, Qxua, Qxua, Qxua, Qxua, Qxua
Qxua, Qxua, Qxua, Qxua, Qxua, Hh, Gs, Ww, Dd^Do, Wwf, Wwf, Wwf, Ww, Wwf, Gs, Gll^Fmw, Gs, Gg, Hh, Gg, Wwf, Ww, Gs^Fms, Wwf, Ww, Wwf, Wwf, Wwf, Dd^Do, Ww, Gs, Gs^Fp, Qxua, Qxua, Qxua, Qxua, Qxua
Qxua, Qxua, Qxua, Qxua, Ch, Gs, Wwf, Wwf, Gs, Wwf, Xu, Xu, Xu, Wwf, Gs, Wwf, Chw, Wwf, Wwf, Wwf, Dd, Gs, Dd, Gs, Xu, Xu, Xu, Wwf, Wwf, Gs, Gs, Gs, Ch, Qxua, Qxua, Qxua, Qxua
Qxua, Qxua, Qxua, Qxua, Ch, Ch, Wwf, Wwf, Wwf, Wwf, Gs, Cud, Xu, Ww, Chw, Wwf, Gs, Gs^Ftp, Hh, Gd^Fts, Wwf, Wwf, Wwf, Hhd, Xu, 7 Cud, Gs, Wwf, Wwf, Ww, Wwf, Ch, Ch, Qxua, Qxua, Qxua, Qxua
Qxua, Qxua, Qxua, Qxua, 4 Xos, Ch, Wwf, Wwf, Gs, Wwf, Wwf, 1 Cud, Xu, Uu, Uu^Uf, Wwf, Wwf, Wwf, Wwf, Hhd, Wwf, Dd^Ftd, Uu^Uf, Uu, Xu, 5 Cud, Wwf, Wwf, Gs, Wwf, Wwf, Ch, 8 Xos, Qxua, Qxua, Qxua, Qxua
Qxua, Qxua, Qxua, Qxua, Ch, Ch, Wwf, Wwf, Wwf, Wwf, Gs, 3 Cud, Xu, Uu, Wwf, Dd^Ftd, Wwf, Hhd, Hh, Wwf, Gs, Wwf, Chw, Uu, Xu, 2 Cud, Gs, Wwf, Wwf, Wwf, Wwf, Ch, Ch, Qxua, Qxua, Qxua, Qxua
Qxua, Qxua, Qxua, Qxua, Ch, Ch, Gs, Wwf, Wwf, Wwf, Xu, 6 Cud, Xu, Hhd, Dd, Wwf, Dd, Gd^Fts, Wwf, Gs^Ftp, Chw, Wwf, Gs, Ww, Xu, Cud, Xu, Wwf, Gs, Wwf, Wwf, Ch, Ch, Qxua, Qxua, Qxua, Qxua
Qxua, Qxua, Qxua, Qxua, Qxua, Gs, Gs, Gs, Dd^Do, Wwf, Wwf, Xu, Ww, Gs, Gs^Fms, Gs, Wwf, Wwf, Hh, Wwf, Gs, Wwf, Gs, Wwf, Ww, Xu, Wwf, Wwf, Dd^Do, Wwf, Gs, Gs, Qxua, Qxua, Qxua, Qxua, Qxua
Qxua, Qxua, Qxua, Qxua, Qxua, Gs^Fp, Gg, Ww, Ww, Wwf, Ch, Wwf, Gg, Wwf, Ww, Ww, Gg, Gg, Aa^Fma, Gg, Gll^Fmw, Gll^Fmw, Hh, Wwf, Gg, Wwf, Ch, Wwf, Ww, Ww, Gg, Hh, Qxua, Qxua, Qxua, Qxua, Qxua
Qxua, Qxua, Qxua, Qxua, Qxua, Qxua, Ha, Gg, Gg, Gg, Gg, Gg, Aa^Fpa, Aa, Aa, Aa, Aa, Aa, Aa, Aa^Fma, Aa^Fpa, Aa, Aa, Ms, Ha, Gg, Gg, Gg, Gg, Gg, Aa^Fpa, Qxua, Qxua, Qxua, Qxua, Qxua, Qxua
Qxua, Qxua, Qxua, Qxua, Qxua, Qxua, Qxua, Aa^Fma, Qxua, Ha, Qxua, Aa^Fpa, Qxua, Qxua, Qxua, Qxua, Qxua, Qxua, Qxua, Qxua, Qxua, Qxua, Qxua, Qxua, Qxua, Ha, Qxua, Aa^Fma, Qxua, Ha, Qxua, Qxua, Qxua, Qxua, Qxua, Qxua, Qxua
Qxua, Qxua, Qxua, Qxua, Qxua, Qxua, Qxua, Qxua, Qxua, Qxua, Qxua, Qxua, Qxua, Qxua, Qxua, Qxua, Qxua, Qxua, Qxua, Qxua, Qxua, Qxua, Qxua, Qxua, Qxua, Qxua, Qxua, Qxua, Qxua, Qxua, Qxua, Qxua, Qxua, Qxua, Qxua, Qxua, Qxua
