Qxua^Xo, Qxua^Xo, Qxua^Xo, Qxua^Xo, Qxua^Xo, Qxua^Xo, Qxua^Xo, Qxua^Xo, Qxua^Xo, Qxua^Xo, Qxua^Xo, Qxua^Xo, Qxua^Xo, Qxua^Xo, Qxua^Xo, Qxua^Xo, Qxua^Xo, Qxua^Xo, Qxua^Xo, Qxua^Xo, Qxua^Xo, Qxua^Xo, Qxua^Xo, Qxua^Xo, Qxua^Xo, Qxua^Xo, Qxua^Xo, Qxua^Xo, Qxua^Xo, Qxua^Xo, Qxua^Xo, Qxua^Xo, Qxua^Xo, Qxua^Xo, Qxua^Xo, Qxua^Xo, Qxua^Xo
Qxua^Xo, Qxua^Xo, Qxua^Xo, Qxua^Xo, Qxua^Xo, Qxua^Xo, Qxua^Xo, Qxua^Xo, Qxua^Xo, Qxua^Xo, Qxua^Xo, Qxua^Xo, Qxua^Xo, Qxua^Xo, Qxua^Xo, Qxua^Xo, Qxua^Xo, Qxua^Xo, Qxua^Xo, Qxua^Xo, Qxua^Xo, Qxua^Xo, Qxua^Xo, Qxua^Xo, Qxua^Xo, Qxua^Xo, Qxua^Xo, Qxua^Xo, Qxua^Xo, Qxua^Xo, Qxua^Xo, Qxua^Xo, Qxua^Xo, Qxua^Xo, Qxua^Xo, Qxua^Xo, Qxua^Xo
Qxua^Xo, Qxua^Xo, Qxua^Xo, Qxua^Xo, Qxua^Xo, Qxua^Xo, Aa^Fpa, Ha, Gg, Aa^Fma, Gg, Ha, Ha, Qxua^Xo, Aa, Qxua^Xo, Aa^Fpa, Qxua^Xo, Aa, Qxua^Xo, Aa, Qxua^Xo, Aa, Qxua^Xo, Aa^Fpa, Aa^Fpa, Gg, Ha, Gg, Aa^Fma, Ha, Qxua^Xo, Qxua^Xo, Qxua^Xo, Qxua^Xo, Qxua^Xo, Qxua^Xo
Qxua^Xo, Qxua^Xo, Qxua^Xo, Qxua^Xo, Qxua^Xo, Qxua^Xo, Gg, Gg, Ww, Gg, Ch, Gg, Gg, Ms, Hh, Aa, Gll^Fmw, Aa^Fma, Hh, Aa, Gg, Aa, Ww, Aa, Gg, Gg, Ch, Gg, Ww, Gg, Gg, Qxua^Xo, Qxua^Xo, Qxua^Xo, Qxua^Xo, Qxua^Xo, Qxua^Xo
Qxua^Xo, Qxua^Xo, Qxua^Xo, Qxua^Xo, Qxua^Xo, Hh, Gg, Ww, Dd^Do, Wwf, Wwf, Wwf, Ww, Wwf, Gg, Gll^Fmw, Wwf, Gg, Dd, Dd, Gs^Fms, Ww, Gs^Fms, Wwf, Ww, Wwf, Wwf, Wwf, Dd^Do, Ww, Gg, Gs^Fp, Qxua^Xo, Qxua^Xo, Qxua^Xo, Qxua^Xo, Qxua^Xo
Qxua^Xo, Qxua^Xo, Qxua^Xo, Qxua^Xo, Hh, Gg, Gg, Wwf, Gg, Wwf, Xu, Xu, Xu, Wwf, Gg, Wwf, Hhd, Dd^Do, Wwf, Wwf, Dd^Do, Gg, Gg, Gg, Xu, Xu, Xu, Wwf, Gg, Gg, Gg, Gg, Gs^Fp, Qxua^Xo, Qxua^Xo, Qxua^Xo, Qxua^Xo
Qxua^Xo, Qxua^Xo, Qxua^Xo, Qxua^Xo, Ch, Gs^Fp, Gg, Gg, Wwf, Gg, Gg, Cud, Xu, Ww, Chw, Wwf, Gll, Wwf, Gd^Fts, Wwf, Wwf, Wwf, Wwf, Hh, Xu, 7 Cud, Gg, Wwf, Wwf, Ww, Gg, Hh, Ch, Qxua^Xo, Qxua^Xo, Qxua^Xo, Qxua^Xo
Qxua^Xo, Qxua^Xo, Qxua^Xo, Ch, 4 Cud, Ch, Wwf, Wwf, Gg, Wwf, Wwf, 1 Cud, Xu, Uu, Uu^Uf, Wwf, Wwf, Hhd, Dd^Dc, Hhd, Wwf, Dd^Ftd, Uu^Uf, Uu, Xu, 5 Cud, Wwf, Wwf, Gg, Wwf, Wwf, Ch, 8 Cud, Ch, Qxua^Xo, Qxua^Xo, Qxua^Xo
Qxua^Xo, Qxua^Xo, Qxua^Xo, Ch, Ch, Ch, Gg, Wwf, Wwf, Wwf, Gg, 3 Cud, Xu, Uu, Wwf, Dd^Ftd, Wwf, Gd^Fts, Hhd, Gd^Fts, Gll, Wwf, Chw, Uu, Xu, 2 Cud, Gg, Wwf, Wwf, Wwf, Gg, Ch, Ch, Ch, Qxua^Xo, Qxua^Xo, Qxua^Xo
Qxua^Xo, Qxua^Xo, Qxua^Xo, Qxua^Xo, Gs^Fp, Hh, Gg, Ww, Gg, Wwf, Xu, 6 Cud, Xu, Hh, Gg, Wwf, Dd^Do, Wwf, Wwf, Wwf, Hhd, Wwf, Gg, Ww, Xu, Cud, Xu, Gg, Gg, Gg, Gg, Gs^Fp, Hh, Qxua^Xo, Qxua^Xo, Qxua^Xo, Qxua^Xo
Qxua^Xo, Qxua^Xo, Qxua^Xo, Qxua^Xo, Qxua^Xo, Gg, Gg, Gg, Dd^Do, Wwf, Wwf, Xu, Ww, Gg, Gs^Fms, Gg, Gs^Fms, Wwf, Dd, Dd^Do, Wwf, Wwf, Gg, Wwf, Ww, Xu, Wwf, Wwf, Dd^Do, Wwf, Gg, Gg, Qxua^Xo, Qxua^Xo, Qxua^Xo, Qxua^Xo, Qxua^Xo
Qxua^Xo, Qxua^Xo, Qxua^Xo, Qxua^Xo, Qxua^Xo, Gs^Fp, Gg, Ww, Ww, Wwf, Ch, Wwf, Gg, Wwf, Ww, Ww, Gg, Dd, Hh, Gg, Gll^Fmw, Gll^Fmw, Hh, Wwf, Gg, Wwf, Ch, Wwf, Ww, Ww, Gg, Hh, Qxua^Xo, Qxua^Xo, Qxua^Xo, Qxua^Xo, Qxua^Xo
Qxua^Xo, Qxua^Xo, Qxua^Xo, Qxua^Xo, Qxua^Xo, Qxua^Xo, Ha, Gg, Gg, Gg, Gg, Gg, Aa^Fpa, Aa, Aa, Aa, Aa, Aa, Aa, Aa^Fma, Aa^Fpa, Aa, Aa, Ms, Ha, Gg, Gg, Gg, Gg, Gg, Aa^Fpa, Qxua^Xo, Qxua^Xo, Qxua^Xo, Qxua^Xo, Qxua^Xo, Qxua^Xo
Qxua^Xo, Qxua^Xo, Qxua^Xo, Qxua^Xo, Qxua^Xo, Qxua^Xo, Qxua^Xo, Aa^Fma, Qxua^Xo, Ha, Qxua^Xo, Aa^Fpa, Qxua^Xo, Qxua^Xo, Qxua^Xo, Qxua^Xo, Qxua^Xo, Qxua^Xo, Qxua^Xo, Qxua^Xo, Qxua^Xo, Qxua^Xo, Qxua^Xo, Qxua^Xo, Qxua^Xo, Ha, Qxua^Xo, Aa^Fma, Qxua^Xo, Ha, Qxua^Xo, Qxua^Xo, Qxua^Xo, Qxua^Xo, Qxua^Xo, Qxua^Xo, Qxua^Xo
Qxua^Xo, Qxua^Xo, Qxua^Xo, Qxua^Xo, Qxua^Xo, Qxua^Xo, Qxua^Xo, Qxua^Xo, Qxua^Xo, Qxua^Xo, Qxua^Xo, Qxua^Xo, Qxua^Xo, Qxua^Xo, Qxua^Xo, Qxua^Xo, Qxua^Xo, Qxua^Xo, Qxua^Xo, Qxua^Xo, Qxua^Xo, Qxua^Xo, Qxua^Xo, Qxua^Xo, Qxua^Xo, Qxua^Xo, Qxua^Xo, Qxua^Xo, Qxua^Xo, Qxua^Xo, Qxua^Xo, Qxua^Xo, Qxua^Xo, Qxua^Xo, Qxua^Xo, Qxua^Xo, Qxua^Xo
